0
0
0
0
0
0
0
0
0
0 7 7 7 0 8 8 8 0 9 9 9 0 10 0 10 10 10
0 7 0 7 0 8 0 8 0 9 0 9 0 10 0 10 0 10
0 0 0 7 0 8 8 8 0 9 9 9 0 10 0 10 0 10
0 0 0 7 0 8 0 8 0 0 0 9 0 10 0 10 0 10
0 0 0 7 0 8 8 8 0 0 0 9 0 10 0 10 10 10
0
0
0 0 7 7 0 8 8 8 0 0 9 9 0 10 0 10 10 10